23S-Mycoplasma amphoriforme Resistant (A2063G)	sk:Bacteria;p:Tenericutes;c:Mollicutes;o:Mycoplasmatales;f:Mycoplasmataceae;g:Mycoplasma;s:Mycoplasma amphoriforme;d:Resistant (A2063G)
23S-Mycoplasma amphoriforme Resistant (A2064G)	sk:Bacteria;p:Tenericutes;c:Mollicutes;o:Mycoplasmatales;f:Mycoplasmataceae;g:Mycoplasma;s:Mycoplasma amphoriforme;d:Resistant (A2064G)
23S-Mycoplasma amphoriforme Sensitive	sk:Bacteria;p:Tenericutes;c:Mollicutes;o:Mycoplasmatales;f:Mycoplasmataceae;g:Mycoplasma;s:Mycoplasma amphoriforme;d:Sensitive
23S-Ureaplasma parvum Resistant (A2063G)	sk:Bacteria;p:Tenericutes;c:Mollicutes;o:Mycoplasmatales;f:Mycoplasmataceae;g:Ureaplasma;s:Ureaplasma parvum;d:Resistant (A2063G)
23S-Ureaplasma parvum Resistant (A2064G)	sk:Bacteria;p:Tenericutes;c:Mollicutes;o:Mycoplasmatales;f:Mycoplasmataceae;g:Ureaplasma;s:Ureaplasma parvum;d:Resistant (A2064G)
23S-Ureaplasma parvum Sensitive	sk:Bacteria;p:Tenericutes;c:Mollicutes;o:Mycoplasmatales;f:Mycoplasmataceae;g:Ureaplasma;s:Ureaplasma parvum;d:Sensitive
23S-Ureaplasma urealyticum Resistant (A2063G)	sk:Bacteria;p:Tenericutes;c:Mollicutes;o:Mycoplasmatales;f:Mycoplasmataceae;g:Ureaplasma;s:Ureaplasma urealyticum;d:Resistant (A2063G)
23S-Ureaplasma urealyticum Resistant (A2064G)	sk:Bacteria;p:Tenericutes;c:Mollicutes;o:Mycoplasmatales;f:Mycoplasmataceae;g:Ureaplasma;s:Ureaplasma urealyticum;d:Resistant (A2064G)
23S-Ureaplasma urealyticum Sensitive	sk:Bacteria;p:Tenericutes;c:Mollicutes;o:Mycoplasmatales;f:Mycoplasmataceae;g:Ureaplasma;s:Ureaplasma urealyticum;d:Sensitive
Acinetobacter baumannii	sk:Bacteria;p:Proteobacteria;c:Gammaproteobacteria;o:Pseudomonadales;f:Moraxellaceae;g:Acinetobacter;s:Acinetobacter baumannii
Bordetella avium	sk:Bacteria;p:Proteobacteria;c:Betaproteobacteria;o:Burkholderiales;f:Alcaligenaceae;g:Bordetella;s:Bordetella avium
Bordetella bronchialis	sk:Bacteria;p:Proteobacteria;c:Betaproteobacteria;o:Burkholderiales;f:Alcaligenaceae;g:Bordetella;s:Bordetella bronchialis
Bordetella bronchiseptica	sk:Bacteria;p:Proteobacteria;c:Betaproteobacteria;o:Burkholderiales;f:Alcaligenaceae;g:Bordetella;s:Bordetella bronchiseptica
Bordetella flabilis	sk:Bacteria;p:Proteobacteria;c:Betaproteobacteria;o:Burkholderiales;f:Alcaligenaceae;g:Bordetella;s:Bordetella flabilis
Bordetella genomosp. 13	sk:Bacteria;p:Proteobacteria;c:Betaproteobacteria;o:Burkholderiales;f:Alcaligenaceae;g:Bordetella;s:Bordetella genomosp. 13
Bordetella genomosp. 6	sk:Bacteria;p:Proteobacteria;c:Betaproteobacteria;o:Burkholderiales;f:Alcaligenaceae;g:Bordetella;s:Bordetella genomosp. 6
Bordetella genomosp. 8	sk:Bacteria;p:Proteobacteria;c:Betaproteobacteria;o:Burkholderiales;f:Alcaligenaceae;g:Bordetella;s:Bordetella genomosp. 8
Bordetella genomosp. 9	sk:Bacteria;p:Proteobacteria;c:Betaproteobacteria;o:Burkholderiales;f:Alcaligenaceae;g:Bordetella;s:Bordetella genomosp. 9
Bordetella hinzii	sk:Bacteria;p:Proteobacteria;c:Betaproteobacteria;o:Burkholderiales;f:Alcaligenaceae;g:Bordetella;s:Bordetella hinzii
Bordetella holmesii	sk:Bacteria;p:Proteobacteria;c:Betaproteobacteria;o:Burkholderiales;f:Alcaligenaceae;g:Bordetella;s:Bordetella holmesii
Bordetella parapertussis	sk:Bacteria;p:Proteobacteria;c:Betaproteobacteria;o:Burkholderiales;f:Alcaligenaceae;g:Bordetella;s:Bordetella parapertussis
Bordetella pertussis	sk:Bacteria;p:Proteobacteria;c:Betaproteobacteria;o:Burkholderiales;f:Alcaligenaceae;g:Bordetella;s:Bordetella pertussis
Bordetella petrii	sk:Bacteria;p:Proteobacteria;c:Betaproteobacteria;o:Burkholderiales;f:Alcaligenaceae;g:Bordetella;s:Bordetella petrii
Bordetella pseudohinzii	sk:Bacteria;p:Proteobacteria;c:Betaproteobacteria;o:Burkholderiales;f:Alcaligenaceae;g:Bordetella;s:Bordetella pseudohinzii
Bordetella sp. H567	sk:Bacteria;p:Proteobacteria;c:Betaproteobacteria;o:Burkholderiales;f:Alcaligenaceae;g:Bordetella;s:Bordetella sp. H567
Bordetella sp. HZ20	sk:Bacteria;p:Proteobacteria;c:Betaproteobacteria;o:Burkholderiales;f:Alcaligenaceae;g:Bordetella;s:Bordetella sp. HZ20
Bordetella sp. N	sk:Bacteria;p:Proteobacteria;c:Betaproteobacteria;o:Burkholderiales;f:Alcaligenaceae;g:Bordetella;s:Bordetella sp. N
Bordetella trematum	sk:Bacteria;p:Proteobacteria;c:Betaproteobacteria;o:Burkholderiales;f:Alcaligenaceae;g:Bordetella;s:Bordetella trematum
Chlamydia abortus	sk:Bacteria;p:Chlamydiae;c:Chlamydiia;o:Chlamydiales;f:Chlamydiaceae;g:Chlamydia;s:Chlamydia abortus
Chlamydia avium	sk:Bacteria;p:Chlamydiae;c:Chlamydiia;o:Chlamydiales;f:Chlamydiaceae;g:Chlamydia;s:Chlamydia avium
Chlamydia caviae	sk:Bacteria;p:Chlamydiae;c:Chlamydiia;o:Chlamydiales;f:Chlamydiaceae;g:Chlamydia;s:Chlamydia caviae
Chlamydia felis	sk:Bacteria;p:Chlamydiae;c:Chlamydiia;o:Chlamydiales;f:Chlamydiaceae;g:Chlamydia;s:Chlamydia felis
Chlamydia gallinacea	sk:Bacteria;p:Chlamydiae;c:Chlamydiia;o:Chlamydiales;f:Chlamydiaceae;g:Chlamydia;s:Chlamydia gallinacea
Chlamydia muridarum	sk:Bacteria;p:Chlamydiae;c:Chlamydiia;o:Chlamydiales;f:Chlamydiaceae;g:Chlamydia;s:Chlamydia muridarum
Chlamydia pecorum	sk:Bacteria;p:Chlamydiae;c:Chlamydiia;o:Chlamydiales;f:Chlamydiaceae;g:Chlamydia;s:Chlamydia pecorum
Chlamydia pneumoniae	sk:Bacteria;p:Chlamydiae;c:Chlamydiia;o:Chlamydiales;f:Chlamydiaceae;g:Chlamydia;s:Chlamydia pneumoniae
Chlamydia psittaci	sk:Bacteria;p:Chlamydiae;c:Chlamydiia;o:Chlamydiales;f:Chlamydiaceae;g:Chlamydia;s:Chlamydia psittaci
Chlamydia sp. 2742-308	sk:Bacteria;p:Chlamydiae;c:Chlamydiia;o:Chlamydiales;f:Chlamydiaceae;g:Chlamydia;s:Chlamydia sp. 2742-308
Chlamydia sp. H15-1957-10C	sk:Bacteria;p:Chlamydiae;c:Chlamydiia;o:Chlamydiales;f:Chlamydiaceae;g:Chlamydia;s:Chlamydia sp. H15-1957-10C
Chlamydia sp. S15-834C	sk:Bacteria;p:Chlamydiae;c:Chlamydiia;o:Chlamydiales;f:Chlamydiaceae;g:Chlamydia;s:Chlamydia sp. S15-834C
Chlamydia suis	sk:Bacteria;p:Chlamydiae;c:Chlamydiia;o:Chlamydiales;f:Chlamydiaceae;g:Chlamydia;s:Chlamydia suis
Chlamydia trachomatis	sk:Bacteria;p:Chlamydiae;c:Chlamydiia;o:Chlamydiales;f:Chlamydiaceae;g:Chlamydia;s:Chlamydia trachomatis
Enterovirus	sk:Viruses;o:Picornavirales;f:Picornaviridae;g:Enterovirus
Enterovirus A	sk:Viruses;o:Picornavirales;f:Picornaviridae;g:Enterovirus;s:Enterovirus A
Enterovirus B	sk:Viruses;o:Picornavirales;f:Picornaviridae;g:Enterovirus;s:Enterovirus B
Enterovirus C	sk:Viruses;o:Picornavirales;f:Picornaviridae;g:Enterovirus;s:Enterovirus C
Enterovirus D	sk:Viruses;o:Picornavirales;f:Picornaviridae;g:Enterovirus;s:Enterovirus D
H1-275-oseltamivir Resistant (H275Y)	sk:Viruses;p:Negarnaviricota;c:Insthoviricetes;o:Articulavirales;f:Orthomyxoviridae;g:Alphainfluenzavirus;s:Influenza A virus;d:H1-275-oseltamivir Resistant (H275Y)
H1-275-oseltamivir Sensitive	sk:Viruses;p:Negarnaviricota;c:Insthoviricetes;o:Articulavirales;f:Orthomyxoviridae;g:Alphainfluenzavirus;s:Influenza A virus;d:H1-275-oseltamivir Sensitive
H3-119-oseltamivir Resistant (E119V)	sk:Viruses;p:Negarnaviricota;c:Insthoviricetes;o:Articulavirales;f:Orthomyxoviridae;g:Alphainfluenzavirus;s:Influenza A virus;d:H3-119-oseltamivir Resistant (E119V)
H3-119-oseltamivir Resistant (I122V)	sk:Viruses;p:Negarnaviricota;c:Insthoviricetes;o:Articulavirales;f:Orthomyxoviridae;g:Alphainfluenzavirus;s:Influenza A virus;d:H3-119-oseltamivir Resistant (I122V)
H3-119-oseltamivir Sensitive	sk:Viruses;p:Negarnaviricota;c:Insthoviricetes;o:Articulavirales;f:Orthomyxoviridae;g:Alphainfluenzavirus;s:Influenza A virus;d:H3-119-oseltamivir Sensitive
H3-292-oseltamivir Resistant (N294S)	sk:Viruses;p:Negarnaviricota;c:Insthoviricetes;o:Articulavirales;f:Orthomyxoviridae;g:Alphainfluenzavirus;s:Influenza A virus;d:H3-292-oseltamivir Resistant (N294S)
H3-292-oseltamivir Resistant (R292K)	sk:Viruses;p:Negarnaviricota;c:Insthoviricetes;o:Articulavirales;f:Orthomyxoviridae;g:Alphainfluenzavirus;s:Influenza A virus;d:H3-292-oseltamivir Resistant (R292K)
H3-292-oseltamivir Sensitive	sk:Viruses;p:Negarnaviricota;c:Insthoviricetes;o:Articulavirales;f:Orthomyxoviridae;g:Alphainfluenzavirus;s:Influenza A virus;d:H3-292-oseltamivir Sensitive
H5-275-oseltamivir Resistant (H275Y)	sk:Viruses;p:Negarnaviricota;c:Insthoviricetes;o:Articulavirales;f:Orthomyxoviridae;g:Alphainfluenzavirus;s:Influenza A virus;d:H5-275-oseltamivir Resistant (H275Y)
H5-275-oseltamivir Sensitive	sk:Viruses;p:Negarnaviricota;c:Insthoviricetes;o:Articulavirales;f:Orthomyxoviridae;g:Alphainfluenzavirus;s:Influenza A virus;d:H5-275-oseltamivir Sensitive
Haemophilus influenzae	sk:Bacteria;p:Proteobacteria;c:Gammaproteobacteria;o:Pasteurellales;f:Pasteurellaceae;g:Haemophilus;s:Haemophilus influenzae
HPIV1	sk:Viruses;p:Negarnaviricota;c:Monjiviricetes;o:Mononegavirales;f:Paramyxoviridae;g:Respirovirus;s:Human respirovirus 1
HPIV2	sk:Viruses;p:Negarnaviricota;c:Monjiviricetes;o:Mononegavirales;f:Paramyxoviridae;g:Rubulavirus;s:Human rubulavirus 2
HPIV3	sk:Viruses;p:Negarnaviricota;c:Monjiviricetes;o:Mononegavirales;f:Paramyxoviridae;g:Respirovirus;s:Human respirovirus 3
HPIV4	sk:Viruses;p:Negarnaviricota;c:Monjiviricetes;o:Mononegavirales;f:Paramyxoviridae;g:Rubulavirus;s:Human rubulavirus 4
Human adenovirus	sk:Viruses;f:Adenoviridae;g:Mastadenovirus;s:Human adenovirus
Human bocavirus	sk:Viruses;f:Parvoviridae;g:Bocaparvovirus;s:Human bocavirus
Human bocavirus 1	sk:Viruses;f:Parvoviridae;g:Bocaparvovirus;s:Primate bocaparvovirus 1;Human bocavirus 1
Human bocavirus 2	sk:Viruses;f:Parvoviridae;g:Bocaparvovirus;s:Primate bocaparvovirus 2;Human bocavirus 2
Human bocavirus 3	sk:Viruses;f:Parvoviridae;g:Bocaparvovirus;s:Primate bocaparvovirus 1;Human bocavirus 3
Human bocavirus 4	sk:Viruses;f:Parvoviridae;g:Bocaparvovirus;s:Human bocavirus 4
Human coronavirus 229E	sk:Viruses;o:Nidovirales;f:Coronaviridae;g:Alphacoronavirus;s:Human coronavirus 229E
Human coronavirus HKU1	sk:Viruses;o:Nidovirales;f:Coronaviridae;g:Betacoronavirus;s:Human coronavirus HKU1
Human coronavirus NL63	sk:Viruses;o:Nidovirales;f:Coronaviridae;g:Alphacoronavirus;s:Human coronavirus NL63
Human coronavirus OC43	sk:Viruses;o:Nidovirales;f:Coronaviridae;g:Betacoronavirus;s:Betacoronavirus 1;Human coronavirus OC43
Human echovirus	sk:Viruses;o:Picornavirales;f:Picornaviridae;g:Enterovirus;s:Human echovirus
Human mastadenovirus A	sk:Viruses;f:Adenoviridae;g:Mastadenovirus;s:Human mastadenovirus A
Human mastadenovirus B	sk:Viruses;f:Adenoviridae;g:Mastadenovirus;s:Human mastadenovirus B
Human mastadenovirus C	sk:Viruses;f:Adenoviridae;g:Mastadenovirus;s:Human mastadenovirus C
Human mastadenovirus D	sk:Viruses;f:Adenoviridae;g:Mastadenovirus;s:Human mastadenovirus D
Human mastadenovirus E	sk:Viruses;f:Adenoviridae;g:Mastadenovirus;s:Human mastadenovirus E
Human metapneumovirus	sk:Viruses;p:Negarnaviricota;c:Monjiviricetes;o:Mononegavirales;f:Pneumoviridae;g:Metapneumovirus;s:Human metapneumovirus
Human respiratory syncytial virus	sk:Viruses;p:Negarnaviricota;c:Monjiviricetes;o:Mononegavirales;f:Pneumoviridae;g:Orthopneumovirus;s:Human orthopneumovirus;Human respiratory syncytial virus
Human respiratory syncytial virus A	sk:Viruses;p:Negarnaviricota;c:Monjiviricetes;o:Mononegavirales;f:Pneumoviridae;g:Orthopneumovirus;s:Human orthopneumovirus;Human respiratory syncytial virus A
Human respiratory syncytial virus B	sk:Viruses;p:Negarnaviricota;c:Monjiviricetes;o:Mononegavirales;f:Pneumoviridae;g:Orthopneumovirus;s:Human orthopneumovirus;Human respiratory syncytial virus B
Human RNaseP	Human RNaseP
Influenza A virus	sk:Viruses;p:Negarnaviricota;c:Insthoviricetes;o:Articulavirales;f:Orthomyxoviridae;g:Alphainfluenzavirus;s:Influenza A virus
Influenza B virus	sk:Viruses;p:Negarnaviricota;c:Insthoviricetes;o:Articulavirales;f:Orthomyxoviridae;g:Betainfluenzavirus;s:Influenza B virus
Influenza B virus - Victoria	sk:Viruses;p:Negarnaviricota;c:Insthoviricetes;o:Articulavirales;f:Orthomyxoviridae;g:Betainfluenzavirus;s:Influenza B virus;Victoria
Influenza B virus - Yamagata	sk:Viruses;p:Negarnaviricota;c:Insthoviricetes;o:Articulavirales;f:Orthomyxoviridae;g:Betainfluenzavirus;s:Influenza B virus;Yamagata
Influenza C virus	sk:Viruses;p:Negarnaviricota;c:Insthoviricetes;o:Articulavirales;f:Orthomyxoviridae;g:Gammainfluenzavirus;s:Influenza C virus
Influenza C virus - Yamagata	sk:Viruses;p:Negarnaviricota;c:Insthoviricetes;o:Articulavirales;f:Orthomyxoviridae;g:Gammainfluenzavirus;s:Influenza C virus;Yamagata
Klebsiella pneumoniae	sk:Bacteria;p:Proteobacteria;c:Gammaproteobacteria;o:Enterobacterales;f:Enterobacteriaceae;g:Klebsiella;s:Klebsiella pneumoniae
Legionella adelaidensis	sk:Bacteria;p:Proteobacteria;c:Gammaproteobacteria;o:Legionellales;f:Legionellaceae;g:Legionella;s:Legionella adelaidensis
Legionella anisa	sk:Bacteria;p:Proteobacteria;c:Gammaproteobacteria;o:Legionellales;f:Legionellaceae;g:Legionella;s:Legionella anisa
Legionella clemsonensis	sk:Bacteria;p:Proteobacteria;c:Gammaproteobacteria;o:Legionellales;f:Legionellaceae;g:Legionella;s:Legionella clemsonensis
Legionella fallonii	sk:Bacteria;p:Proteobacteria;c:Gammaproteobacteria;o:Legionellales;f:Legionellaceae;g:Legionella;s:Legionella fallonii
Legionella jordanis	sk:Bacteria;p:Proteobacteria;c:Gammaproteobacteria;o:Legionellales;f:Legionellaceae;g:Legionella;s:Legionella jordanis
Legionella lansingensis	sk:Bacteria;p:Proteobacteria;c:Gammaproteobacteria;o:Legionellales;f:Legionellaceae;g:Legionella;s:Legionella lansingensis
Legionella longbeachae	sk:Bacteria;p:Proteobacteria;c:Gammaproteobacteria;o:Legionellales;f:Legionellaceae;g:Legionella;s:Legionella longbeachae
Legionella oakridgensis	sk:Bacteria;p:Proteobacteria;c:Gammaproteobacteria;o:Legionellales;f:Legionellaceae;g:Legionella;s:Legionella oakridgensis
Legionella pneumophila	sk:Bacteria;p:Proteobacteria;c:Gammaproteobacteria;o:Legionellales;f:Legionellaceae;g:Legionella;s:Legionella pneumophila
Legionella pneumophila sg1	sk:Bacteria;p:Proteobacteria;c:Gammaproteobacteria;o:Legionellales;f:Legionellaceae;g:Legionella;s:Legionella pneumophila;t:sg1
Legionella spiritensis	sk:Bacteria;p:Proteobacteria;c:Gammaproteobacteria;o:Legionellales;f:Legionellaceae;g:Legionella;s:Legionella spiritensis
Legionella waltersii	sk:Bacteria;p:Proteobacteria;c:Gammaproteobacteria;o:Legionellales;f:Legionellaceae;g:Legionella;s:Legionella waltersii
MERS	sk:Viruses;o:Nidovirales;f:Coronaviridae;g:Betacoronavirus;s:Middle East respiratory syndrome-related coronavirus
Moraxella catarrhalis	sk:Bacteria;p:Proteobacteria;c:Gammaproteobacteria;o:Pseudomonadales;f:Moraxellaceae;g:Moraxella;s:Moraxella catarrhalis
Mycoplasma Pneumoniae P-type 1	sk:Bacteria;p:Tenericutes;c:Mollicutes;o:Mycoplasmatales;f:Mycoplasmataceae;g:Mycoplasma;s:Mycoplasma pneumoniae;t:P1-type 1
Mycoplasma Pneumoniae P-type 2	sk:Bacteria;p:Tenericutes;c:Mollicutes;o:Mycoplasmatales;f:Mycoplasmataceae;g:Mycoplasma;s:Mycoplasma pneumoniae;t:P1-type 2
Mycoplasma pneumoniae macrolide resistant	sk:Bacteria;p:Tenericutes;c:Mollicutes;o:Mycoplasmatales;f:Mycoplasmataceae;g:Mycoplasma;s:Mycoplasma pneumoniae;d:Macrolide resistant
Mycoplasma pneumoniae macrolide sensitive	sk:Bacteria;p:Tenericutes;c:Mollicutes;o:Mycoplasmatales;f:Mycoplasmataceae;g:Mycoplasma;s:Mycoplasma pneumoniae;d:Macrolide sensitive
Non-human adenovirus	Not found
Non-human bocavirus	Not found
Non-human enterovirus	Not found
Non-human streptococcus	Not found
Parechovirus A	sk:Viruses;o:Picornavirales;f:Picornaviridae;g:Parechovirus;s:Parechovirus A
Positive control A. baumannii	Not found
Positive control Bordetella-1	Not found
Positive control Bordetella-2	Not found
Positive control Chlamydia	Not found
Positive control FluC	Not found
Positive control GBS	Not found
Positive control H1-275-oseltamivir	Not found
Positive control H3-119-oseltamivir	Not found
Positive control H3-292-oseltamivir	Not found
Positive control H5-275-oseltamivir	Not found
Positive control HBoV	Not found
Positive control HCoV-1	Not found
Positive control HCoV-2	Not found
Positive control HPEV	Not found
Positive control HPIV1	Not found
Positive control HPIV2	Not found
Positive control HPIV3	Not found
Positive control HPIV4	Not found
Positive control Human Metapneumovirus	Not found
Positive control K. pneumoniae	Not found
Positive control L. pneumophila sg1	Not found
Positive control M. catarrhalis	Not found
Positive control M. pneumoniae - macrolide resistance	Not found
Positive control M. pneumoniae - P1 typing	Not found
Positive control P. aeruginosa	Not found
Positive control Pan-ADEV	Not found
Positive control Pan-FluA	Not found
Positive control Pan-FluB-2	Not found
Positive control Pan-H. influenzae	Not found
Positive control Pan-Legionella	Not found
Positive control RHIV/ENTV	Not found
Positive control RNaseP (human)	Not found
Positive control RSV	Not found
Positive control S. aureus	Not found
Positive control Strep	Not found
Pseudomonas aeruginosa	sk:Bacteria;p:Proteobacteria;c:Gammaproteobacteria;o:Pseudomonadales;f:Pseudomonadaceae;g:Pseudomonas;s:Pseudomonas aeruginosa
Respiratory syncytial virus	sk:Viruses;p:Negarnaviricota;c:Monjiviricetes;o:Mononegavirales;f:Pneumoviridae;s:Respiratory syncytial virus
Rhinovirus	sk:Viruses;o:Picornavirales;f:Picornaviridae;g:Enterovirus;s:Rhinovirus
Rhinovirus A	sk:Viruses;o:Picornavirales;f:Picornaviridae;g:Enterovirus;s:Rhinovirus A
Rhinovirus B	sk:Viruses;o:Picornavirales;f:Picornaviridae;g:Enterovirus;s:Rhinovirus B
Rhinovirus C	sk:Viruses;o:Picornavirales;f:Picornaviridae;g:Enterovirus;s:Rhinovirus C
SARS	sk:Viruses;o:Nidovirales;f:Coronaviridae;g:Betacoronavirus;s:Severe acute respiratory syndrome-related coronavirus
Staphylococcus aureus	sk:Bacteria;p:Firmicutes;c:Bacilli;o:Bacillales;f:Staphylococcaceae;g:Staphylococcus;s:Staphylococcus aureus
Streptococcus acidominimus	sk:Bacteria;p:Firmicutes;c:Bacilli;o:Lactobacillales;f:Streptococcaceae;g:Streptococcus;s:Streptococcus acidominimus
Streptococcus agalactiae	sk:Bacteria;p:Firmicutes;c:Bacilli;o:Lactobacillales;f:Streptococcaceae;g:Streptococcus;s:Streptococcus agalactiae
Streptococcus anginosus	sk:Bacteria;p:Firmicutes;c:Bacilli;o:Lactobacillales;f:Streptococcaceae;g:Streptococcus;s:Streptococcus anginosus
Streptococcus australis	sk:Bacteria;p:Firmicutes;c:Bacilli;o:Lactobacillales;f:Streptococcaceae;g:Streptococcus;s:Streptococcus australis
Streptococcus canis	sk:Bacteria;p:Firmicutes;c:Bacilli;o:Lactobacillales;f:Streptococcaceae;g:Streptococcus;s:Streptococcus canis
Streptococcus constellatus	sk:Bacteria;p:Firmicutes;c:Bacilli;o:Lactobacillales;f:Streptococcaceae;g:Streptococcus;s:Streptococcus constellatus
Streptococcus criceti	sk:Bacteria;p:Firmicutes;c:Bacilli;o:Lactobacillales;f:Streptococcaceae;g:Streptococcus;s:Streptococcus criceti
Streptococcus cristatus	sk:Bacteria;p:Firmicutes;c:Bacilli;o:Lactobacillales;f:Streptococcaceae;g:Streptococcus;s:Streptococcus cristatus
Streptococcus dysgalactiae	sk:Bacteria;p:Firmicutes;c:Bacilli;o:Lactobacillales;f:Streptococcaceae;g:Streptococcus;s:Streptococcus dysgalactiae
Streptococcus equinus	sk:Bacteria;p:Firmicutes;c:Bacilli;o:Lactobacillales;f:Streptococcaceae;g:Streptococcus;s:Streptococcus equinus
Streptococcus ferus	sk:Bacteria;p:Firmicutes;c:Bacilli;o:Lactobacillales;f:Streptococcaceae;g:Streptococcus;s:Streptococcus ferus
Streptococcus gallolyticus	sk:Bacteria;p:Firmicutes;c:Bacilli;o:Lactobacillales;f:Streptococcaceae;g:Streptococcus;s:Streptococcus gallolyticus
Streptococcus gordonii	sk:Bacteria;p:Firmicutes;c:Bacilli;o:Lactobacillales;f:Streptococcaceae;g:Streptococcus;s:Streptococcus gordonii
Streptococcus halotolerans	sk:Bacteria;p:Firmicutes;c:Bacilli;o:Lactobacillales;f:Streptococcaceae;g:Streptococcus;s:Streptococcus halotolerans
Streptococcus himalayensis	sk:Bacteria;p:Firmicutes;c:Bacilli;o:Lactobacillales;f:Streptococcaceae;g:Streptococcus;s:Streptococcus himalayensis
Streptococcus infantarius	sk:Bacteria;p:Firmicutes;c:Bacilli;o:Lactobacillales;f:Streptococcaceae;g:Streptococcus;s:Streptococcus infantarius
Streptococcus iniae	sk:Bacteria;p:Firmicutes;c:Bacilli;o:Lactobacillales;f:Streptococcaceae;g:Streptococcus;s:Streptococcus iniae
Streptococcus intermedius	sk:Bacteria;p:Firmicutes;c:Bacilli;o:Lactobacillales;f:Streptococcaceae;g:Streptococcus;s:Streptococcus intermedius
Streptococcus lutetiensis	sk:Bacteria;p:Firmicutes;c:Bacilli;o:Lactobacillales;f:Streptococcaceae;g:Streptococcus;s:Streptococcus lutetiensis
Streptococcus macedonicus	sk:Bacteria;p:Firmicutes;c:Bacilli;o:Lactobacillales;f:Streptococcaceae;g:Streptococcus;s:Streptococcus macedonicus
Streptococcus marmotae	sk:Bacteria;p:Firmicutes;c:Bacilli;o:Lactobacillales;f:Streptococcaceae;g:Streptococcus;s:Streptococcus marmotae
Streptococcus merionis	sk:Bacteria;p:Firmicutes;c:Bacilli;o:Lactobacillales;f:Streptococcaceae;g:Streptococcus;s:Streptococcus merionis
Streptococcus milleri	sk:Bacteria;p:Firmicutes;c:Bacilli;o:Lactobacillales;f:Streptococcaceae;g:Streptococcus;s:Streptococcus milleri
Streptococcus mitis	sk:Bacteria;p:Firmicutes;c:Bacilli;o:Lactobacillales;f:Streptococcaceae;g:Streptococcus;s:Streptococcus mitis
Streptococcus mutans	sk:Bacteria;p:Firmicutes;c:Bacilli;o:Lactobacillales;f:Streptococcaceae;g:Streptococcus;s:Streptococcus mutans
Streptococcus oralis	sk:Bacteria;p:Firmicutes;c:Bacilli;o:Lactobacillales;f:Streptococcaceae;g:Streptococcus;s:Streptococcus oralis
Streptococcus pantholopis	sk:Bacteria;p:Firmicutes;c:Bacilli;o:Lactobacillales;f:Streptococcaceae;g:Streptococcus;s:Streptococcus pantholopis
Streptococcus parasanguinis	sk:Bacteria;p:Firmicutes;c:Bacilli;o:Lactobacillales;f:Streptococcaceae;g:Streptococcus;s:Streptococcus parasanguinis
Streptococcus parauberis	sk:Bacteria;p:Firmicutes;c:Bacilli;o:Lactobacillales;f:Streptococcaceae;g:Streptococcus;s:Streptococcus parauberis
Streptococcus pasteurianus	sk:Bacteria;p:Firmicutes;c:Bacilli;o:Lactobacillales;f:Streptococcaceae;g:Streptococcus;s:Streptococcus pasteurianus
Streptococcus pluranimalium	sk:Bacteria;p:Firmicutes;c:Bacilli;o:Lactobacillales;f:Streptococcaceae;g:Streptococcus;s:Streptococcus pluranimalium
Streptococcus pneumoniae	sk:Bacteria;p:Firmicutes;c:Bacilli;o:Lactobacillales;f:Streptococcaceae;g:Streptococcus;s:Streptococcus pneumoniae
Streptococcus porcinus	sk:Bacteria;p:Firmicutes;c:Bacilli;o:Lactobacillales;f:Streptococcaceae;g:Streptococcus;s:Streptococcus porcinus
Streptococcus pseudopneumoniae	sk:Bacteria;p:Firmicutes;c:Bacilli;o:Lactobacillales;f:Streptococcaceae;g:Streptococcus;s:Streptococcus pseudopneumoniae
Streptococcus pseudoporcinus	sk:Bacteria;p:Firmicutes;c:Bacilli;o:Lactobacillales;f:Streptococcaceae;g:Streptococcus;s:Streptococcus pseudoporcinus
Streptococcus pyogenes	sk:Bacteria;p:Firmicutes;c:Bacilli;o:Lactobacillales;f:Streptococcaceae;g:Streptococcus;s:Streptococcus pyogenes
Streptococcus respiraculi	sk:Bacteria;p:Firmicutes;c:Bacilli;o:Lactobacillales;f:Streptococcaceae;g:Streptococcus;s:Streptococcus respiraculi
Streptococcus ruminantium	sk:Bacteria;p:Firmicutes;c:Bacilli;o:Lactobacillales;f:Streptococcaceae;g:Streptococcus;s:Streptococcus ruminantium
Streptococcus salivarius	sk:Bacteria;p:Firmicutes;c:Bacilli;o:Lactobacillales;f:Streptococcaceae;g:Streptococcus;s:Streptococcus salivarius
Streptococcus sanguinis	sk:Bacteria;p:Firmicutes;c:Bacilli;o:Lactobacillales;f:Streptococcaceae;g:Streptococcus;s:Streptococcus sanguinis
Streptococcus sobrinus	sk:Bacteria;p:Firmicutes;c:Bacilli;o:Lactobacillales;f:Streptococcaceae;g:Streptococcus;s:Streptococcus sobrinus
Streptococcus sp. 6400988	sk:Bacteria;p:Firmicutes;c:Bacilli;o:Lactobacillales;f:Streptococcaceae;g:Streptococcus;s:Streptococcus sp. 6400988
Streptococcus sp. 6401233	sk:Bacteria;p:Firmicutes;c:Bacilli;o:Lactobacillales;f:Streptococcaceae;g:Streptococcus;s:Streptococcus sp. 6401233
Streptococcus sp. 6401638	sk:Bacteria;p:Firmicutes;c:Bacilli;o:Lactobacillales;f:Streptococcaceae;g:Streptococcus;s:Streptococcus sp. 6401638
Streptococcus sp. A12	sk:Bacteria;p:Firmicutes;c:Bacilli;o:Lactobacillales;f:Streptococcaceae;g:Streptococcus;s:Streptococcus sp. A12
Streptococcus sp. ChDC B345	sk:Bacteria;p:Firmicutes;c:Bacilli;o:Lactobacillales;f:Streptococcaceae;g:Streptococcus;s:Streptococcus sp. ChDC B345
Streptococcus sp. FDAARGOS 192	sk:Bacteria;p:Firmicutes;c:Bacilli;o:Lactobacillales;f:Streptococcaceae;g:Streptococcus;s:Streptococcus sp. FDAARGOS_192
Streptococcus sp. FDAARGOS 520	sk:Bacteria;p:Firmicutes;c:Bacilli;o:Lactobacillales;f:Streptococcaceae;g:Streptococcus;s:Streptococcus sp. FDAARGOS_520
Streptococcus sp. FDAARGOS 521	sk:Bacteria;p:Firmicutes;c:Bacilli;o:Lactobacillales;f:Streptococcaceae;g:Streptococcus;s:Streptococcus sp. FDAARGOS_521
Streptococcus sp. FDAARGOS 522	sk:Bacteria;p:Firmicutes;c:Bacilli;o:Lactobacillales;f:Streptococcaceae;g:Streptococcus;s:Streptococcus sp. FDAARGOS_522
Streptococcus sp. 'group B'	sk:Bacteria;p:Firmicutes;c:Bacilli;o:Lactobacillales;f:Streptococcaceae;g:Streptococcus;s:Streptococcus sp. 'group B'
Streptococcus sp. I-G2	sk:Bacteria;p:Firmicutes;c:Bacilli;o:Lactobacillales;f:Streptococcaceae;g:Streptococcus;s:Streptococcus sp. I-G2
Streptococcus sp. I-P16	sk:Bacteria;p:Firmicutes;c:Bacilli;o:Lactobacillales;f:Streptococcaceae;g:Streptococcus;s:Streptococcus sp. I-P16
Streptococcus sp. JS71	sk:Bacteria;p:Firmicutes;c:Bacilli;o:Lactobacillales;f:Streptococcaceae;g:Streptococcus;s:Streptococcus sp. JS71
Streptococcus sp. KCOM 2412	sk:Bacteria;p:Firmicutes;c:Bacilli;o:Lactobacillales;f:Streptococcaceae;g:Streptococcus;s:Streptococcus sp. KCOM 2412
Streptococcus sp. NPS 308	sk:Bacteria;p:Firmicutes;c:Bacilli;o:Lactobacillales;f:Streptococcaceae;g:Streptococcus;s:Streptococcus sp. NPS 308
Streptococcus sp. oral taxon 064	sk:Bacteria;p:Firmicutes;c:Bacilli;o:Lactobacillales;f:Streptococcaceae;g:Streptococcus;s:Streptococcus sp. oral taxon 064
Streptococcus sp. oral taxon 431	sk:Bacteria;p:Firmicutes;c:Bacilli;o:Lactobacillales;f:Streptococcaceae;g:Streptococcus;s:Streptococcus sp. oral taxon 431
Streptococcus sp. VT 162	sk:Bacteria;p:Firmicutes;c:Bacilli;o:Lactobacillales;f:Streptococcaceae;g:Streptococcus;s:Streptococcus sp. VT 162
Streptococcus sp. Z15	sk:Bacteria;p:Firmicutes;c:Bacilli;o:Lactobacillales;f:Streptococcaceae;g:Streptococcus;s:Streptococcus sp. Z15
Streptococcus suis	sk:Bacteria;p:Firmicutes;c:Bacilli;o:Lactobacillales;f:Streptococcaceae;g:Streptococcus;s:Streptococcus suis
Streptococcus thermophilus	sk:Bacteria;p:Firmicutes;c:Bacilli;o:Lactobacillales;f:Streptococcaceae;g:Streptococcus;s:Streptococcus thermophilus
Streptococcus troglodytae	sk:Bacteria;p:Firmicutes;c:Bacilli;o:Lactobacillales;f:Streptococcaceae;g:Streptococcus;s:Streptococcus troglodytae
Streptococcus uberis	sk:Bacteria;p:Firmicutes;c:Bacilli;o:Lactobacillales;f:Streptococcaceae;g:Streptococcus;s:Streptococcus uberis
Streptococcus urinalis	sk:Bacteria;p:Firmicutes;c:Bacilli;o:Lactobacillales;f:Streptococcaceae;g:Streptococcus;s:Streptococcus urinalis
Streptococcus vestibularis	sk:Bacteria;p:Firmicutes;c:Bacilli;o:Lactobacillales;f:Streptococcaceae;g:Streptococcus;s:Streptococcus vestibularis
Streptococcus viridans	sk:Bacteria;p:Firmicutes;c:Bacilli;o:Lactobacillales;f:Streptococcaceae;g:Streptococcus;s:Streptococcus viridans
